BBBBBBBBBBB
B...B.B...B
B.B.B.B.BBB
BSB.....B.B
B.BBBB.BB.B
B.B.....B.B
BBBBBBBXBBB